XXXXXXXX
XXGGGXXX
XXGXGXXX
XXGGGXXX
XDGGGBAX
XXGGGXXX
XXGXGXXX
XXGGGXXX
XXXXXXXX